111111111111111111111111111111
1*666666666666p6666666666666*1
161111611116111111611116111161
161*6666666666666666666666*161
161611611116111111611116116161
16161*666666666666666666*16161
166666166661111611166666666661
161616116666666666666611616161
161616166161666666161661616161
161616161161111611161161616161
161616666666666666666666616161
166666166661111611166661666661
161616166666666666666661616161
16161616116111~~11161161616161
161616661161g----g161166616161
161616161161g----g161161616161
161616161161111111161161616161
161666166666666666666661616161
166666666661111611166666666661
161616666666666666666666616161
161616161161111611161161616161
161616166161666666161661616161
161616116666666666666611616161
166666166661111611166661666661
16161*666666666666666666*16161
161611611116111111611116116161
161*6666666666666666666666*161
161111611116111111611116111161
1*66666666666666666666666666*1
111111111111111111111111111111


p pacman
g ghost
1 wall
~ gate
6 ball
* big-ball
- blank



