1 R
5 D
25 24 23 22 21 20 19 18 17 
26 51 50 49 48 47 46 45 16 
27 52 69 68 67 66 65 44 15 
28 53 70 79 78 77 64 43 14 
29 54 71 80 81 76 63 42 13 
30 55 72 73 74 75 62 41 12 
31 56 57 58 59 60 61 40 11 
32 33 34 35 36 37 38 39 10 
1  2  3  4  5  6  7  8  9  
