5 L
1 U
19 18 17 16 15 14 13 
20 37 36 35 34 33 12 
21 38 47 46 45 32 11 
22 39 48 49 44 31 10 
23 40 41 42 43 30 9  
24 25 26 27 28 29 8  
1  2  3  4  5  6  7  
